1 1 1 1 1 1 1 1 1 1 1 1 1
1 999 0 1 0 5 5 6 6 6 903 903 1
1 0 0 1 0 5 0 0 0 6 0 903 1
1 0 0 1 0 5 0 5 0 4 0 4 1
1 0 1 1 0 5 0 5 0 0 0 0 1
1 0 0 7 0 0 0 5 4 3 3 0 1
1 0 0 7 0 7 7 0 0 0 3 0 1
1 0 0 0 0 0 0 0 0 0 3 0 1
1 0 0 0 0 0 0 0 0 0 3 0 1
1 0 0 0 0 0 0 3 3 3 3 0 1
1 0 0 0 0 0 0 3 0 0 0 0 1
1 902 0 0 0 0 0 2 0 2 2 2 1
1 900 901 0 0 0 0 2 0 0 0 0 1
1 1 1 1 1 1 1 1 1 1 1 1 1