1   1   1   1   1   1   1   1   1   1   1   1   1   1   1   1   1   1   1   1   1   1   1   1   1   1   1   1   1   1   1
1   900 0   0   0   0   0   0   0   0   0   0   0   0   0   0   0   0   0   0   0   0   0   0   0   0   0   0   0   0   1
1   0   0   0   1   1   1   1   1   1   1   1   1   1   1   1   0   1   1   1   1   1   1   1   1   1   1   1   1   0   1
1   0   1   1   1   0   0   0   0   0   0   1   900 0   0   0   0   0   0   0   900 1   0   0   0   0   0   0   1   0   1
1   0   1   900 1   0   0   0   0   0   0   1   0   0   0   0   0   0   0   0   0   1   0   1   1   1   1   0   1   0   1
1   0   1   0   1   0   0   0   0   0   0   1   0   0   0   0   0   0   0   0   0   1   0   0   0   0   1   0   1   0   1
1   0   0   0   1   0   0   0   0   0   0   1   0   0   0   0   0   0   0   0   0   1   1   1   1   0   1   0   1   0   1
1   0   1   0   1   0   0   0   0   0   0   1   900 0   0   0   0   0   0   0   900 1   0   0   1   0   1   0   1   0   1
1   0   1   900 1   0   0   0   0   0   0   1   1   1   1   1   1   1   1   1   1   1   0   0   1   0   1   0   1   0   1
1   0   1   1   1   0   0   0   0   0   0   0   0   0   0   0   0   0   0   0   0   0   0   0   1   0   1   0   1   0   1
1   0   1   900 1   0   0   0   0   0   0   0   0   0   0   0   0   0   0   0   0   0   0   0   1   0   1   0   0   0   1
1   0   1   0   1   0   0   0   0   0   0   0   0   0   0   0   0   0   0   0   0   0   0   0   1   0   1   1   1   1   1
1   0   1   0   1   0   0   0   0   0   0   0   0   0   0   0   0   0   0   0   0   0   0   0   1   0   0   0   0   900 1
1   0   0   0   1   0   0   0   0   0   0   0   0   0   0   0   0   0   0   0   0   0   0   0   1   0   0   0   0   0   1
1   0   1   0   1   0   0   0   0   0   0   0   0   0   0   0   0   0   0   0   0   0   0   0   1   0   0   0   0   0   1
1   0   1   0   1   0   0   0   0   0   0   0   0   0   0   0   0   0   0   0   0   0   0   900 0   0   0   0   0   0   1
1   0   1   900 1   0   0   0   0   0   0   0   0   0   0   0   0   0   0   0   0   0   0   0   1   0   0   0   0   900 1
1   0   1   1   1   1   1   1   0   0   0   0   0   0   0   0   0   0   0   0   0   0   0   0   1   1   1   1   1   1   1
1   0   0   0   0   0   0   1   0   0   0   0   0   0   0   0   0   0   0   0   0   0   0   0   0   0   0   0   0   0   1
1   0   0   0   900 1   0   1   0   0   0   0   0   0   0   0   0   0   0   0   0   0   0   0   0   0   0   0   0   0   1
1   1   1   1   1   1   0   1   1   0   0   0   0   0   0   0   0   0   0   0   0   0   0   0   0   0   0   0   0   0   1
1   0   0   0   0   0   0   0   1   1   1   0   0   0   0   0   0   0   0   0   0   0   0   0   0   0   0   0   0   0   1
1   0   1   0   1   1   1   0   0   0   1   0   0   0   0   0   0   0   0   0   0   0   0   0   0   0   0   0   0   0   1
1   0   1   0   0   0   1   1   1   0   1   0   0   0   0   0   0   0   0   0   0   0   0   0   0   0   0   0   0   0   1
1   0   1   0   0   0   900 902 1   0   1   1   1   1   1   1   1   1   1   1   1   1   1   1   0   0   0   0   0   0   1
1   999 1   0   0   0   1   1   1   0   0   0   0   0   0   0   0   0   0   0   0   0   900 1   0   0   0   0   0   0   1
1   1   1   1   1   1   1   1   1   1   1   1   1   1   1   1   1   1   1   1   1   1   1   1   1   1   1   1   1   1   1
