11111111111111111
10000000000000001
11002000000000001
11002000000000001
11002000000000001
11012000000000001
11000000000000001
10000220000000001
10000220000000001
10000000000000001
10000000000000001
11111111111111111